playerstart 0 3
0 0 0 0 0 0 0 0 0 0 0 0 0 0 0 0 0 0 0 0 0 0 0 0 0 0 0 0 0 0 
0 6 6 6 6 6 1 6 6 6 6 6 1 6 6 6 6 4 6 6 6 6 6 6 1 6 1 6 3 0
0 6 4 4 6 4 4 4 4 4 4 6 4 4 4 4 4 4 4 4 4 4 6 4 4 4 4 4 3 0
6 6 6 6 6 6 1 6 6 6 4 6 4 6 4 6 6 6 6 6 6 4 6 4 6 4 6 6 3 0
0 4 4 4 4 4 4 4 4 6 4 6 4 6 6 6 4 6 6 6 6 4 6 4 6 4 6 4 3 0
0 6 6 6 4 6 4 4 4 6 4 6 4 6 4 4 4 6 4 4 4 4 6 6 6 6 6 4 3 0
0 6 4 6 6 6 6 4 6 6 6 6 4 6 4 1 4 6 6 4 6 4 6 6 4 4 4 4 3 0
0 6 4 4 4 4 6 4 6 4 6 4 4 6 4 6 4 6 6 6 6 6 6 6 6 4 1 3 3 0
0 6 6 1 4 4 6 6 6 6 6 4 6 6 4 6 4 6 6 4 4 4 4 6 6 4 1 3 3 0
0 6 4 6 4 6 6 4 6 4 6 4 6 6 4 6 4 4 6 6 6 6 4 6 6 4 6 3 3 0
0 6 4 6 4 6 6 4 6 4 6 6 6 6 4 1 6 6 6 4 6 6 4 4 6 6 6 6 6 0
0 6 4 6 4 6 6 4 4 4 4 4 4 4 4 4 4 4 4 4 6 6 4 6 6 4 6 4 6 0
0 1 4 6 4 6 4 4 6 6 6 4 6 4 1 6 6 6 1 6 6 6 4 6 4 4 6 4 1 0
0 6 4 6 4 6 6 6 6 6 6 6 1 4 6 6 4 6 6 4 4 6 4 6 6 4 6 4 6 0
0 6 4 1 4 4 4 4 4 4 6 4 6 4 6 6 4 6 6 4 6 6 4 4 6 4 6 4 6 0
0 6 4 6 4 6 6 6 6 6 6 4 6 6 6 6 4 4 4 4 6 4 4 6 6 4 1 4 6 0
0 6 4 6 6 6 4 4 4 4 4 4 4 6 6 6 6 6 6 6 6 4 6 6 4 4 6 4 6 0
0 6 4 4 4 4 4 6 6 6 4 1 6 6 2 2 2 2 1 6 6 4 4 4 4 4 4 4 6 0
0 6 6 6 6 6 6 6 4 6 6 6 4 6 2 2 2 2 6 6 6 6 6 1 1 6 6 6 6 0
0 6 0 0 0 0 0 0 0 0 0 0 0 0 0 0 0 0 0 0 0 0 0 0 0 0 0 0 0 0