playerstart 28 0
4 4 4 4 4 0 0 4 4 4 4 13 4 4 4 4 4 4 4 4 13 13 13 4 4 4 4 4 6 4 
4 34 34 4 6 1 1 1 7 7 7 1 4 1 1 1 1 6 6 7 13 6 6 6 6 6 6 6 6 4
4 4 4 4 6 6 4 4 4 4 13 4 4 6 4 4 4 4 4 4 4 4 4 4 4 4 4 4 6 4
28 28 28 4 1 1 1 4 6 6 6 4 6 6 6 4 6 6 7 7 7 6 6 4 6 6 6 4 6 4
4 29 28 4 6 4 6 4 1 4 6 4 6 4 6 4 7 4 6 4 6 4 6 4 6 4 6 4 6 4
4 29 28 4 6 4 7 4 6 4 6 4 7 4 6 4 6 4 6 4 6 16 7 4 6 16 6 4 6 4
4 29 28 4 6 4 7 4 1 4 6 4 7 4 7 4 1 4 6 4 6 16 6 4 6 4 6 16 6 4
4 28 29 0 7 4 7 4 1 4 7 4 6 4 6 4 7 4 6 4 6 4 6 4 6 4 6 4 6 4
4 28 28 0 7 16 6 4 6 4 6 16 6 4 1 4 6 4 6 4 6 4 6 4 6 4 6 4 6 4
4 28 28 0 6 4 6 4 6 4 6 4 6 4 6 4 1 4 6 4 6 4 6 4 6 4 6 4 6 4
4 28 28 4 1 4 1 16 6 16 6 4 6 4 6 4 7 4 6 4 6 4 6 16 6 4 6 4 6 4
4 28 29 5 6 4 1 5 6 4 7 4 6 4 7 4 6 4 6 4 6 4 6 4 6 4 6 4 6 4
4 29 28 0 1 4 1 5 6 4 7 4 6 4 7 4 7 4 6 4 6 4 6 16 6 4 6 4 6 4
4 28 27 5 6 4 6 4 7 4 6 4 6 4 7 4 6 4 7 4 6 4 6 4 6 4 6 4 6 4
4 28 27 16 1 4 1 4 6 4 6 4 1 4 6 4 6 4 6 4 6 4 6 4 6 4 6 4 6 4
4 27 27 16 1 4 6 4 7 4 6 4 6 4 6 4 6 4 6 4 6 4 6 4 6 4 6 16 6 4
4 21 27 28 1 4 6 7 7 4 6 6 6 4 6 6 6 4 6 6 6 4 6 6 6 4 6 6 6 4
4 27 28 16 16 4 4 4 4 4 13 4 4 4 4 6 4 13 13 4 4 4 4 4 4 4 6 4 4 4
4 28 28 28 19 6 6 6 6 6 6 13 6 6 6 6 6 6 6 13 6 6 6 6 6 6 6 4 31 31
4 4 4 4 4 4 4 4 4 4 4 4 13 4 13 4 4 4 4 4 4 4 4 4 4 4 4 4 31 31
